.
abide 	abided / abode 	abided#[əˈbaɪd]#lưu trú, lưu lại
alight 	alighted / alit 	alighted / alit#[əˈlaɪt]#xuống, bước xuống
arise 	arose 	arisen#[əˈraɪz]#phát sinh
awake 	awakened / awoke 	awakened / awoken#[əˈweɪk]#đánh thức, thức
backbite 	backbit 	backbitten#[ˈbæk.baɪt]#nói vụng, nói xấu sau lưng
backslide 	backslid 	backslidden / backslid#[ˈbæk.slaɪd]#tái phạm, sa ngã
be 	was/were 	been#[bi]#thì, là, ở
bear 	bore 	born / borne#[beə(r)]#mang, chịu đựng
beat 	beat 	beaten / beat#[biːt]#đánh đập, đấm
become 	became 	become#[bɪˈkʌm]#trở nên
befall 	befell 	befallen#[bɪˈfɔːl]#xảy đến
beget 	begat / begot 	begotten#[bɪˈɡet]#sinh ra, gây ra
begin 	began 	begun#[bɪˈɡɪn]#bắt đầu
behold 	beheld 	beheld#[bɪˈhəʊld]#ngắm nhìn
bend 	bent 	bent#[bent∫]#bẻ cong
bereave 	bereaved / bereft 	bereaved / bereft#[bɪˈriːv]#làm mất, lấy mất
beseech 	besought / beseeched 	besought / beseeched#[bɪˈsiːtʃ]#cầu xin, cầu khẩn
beset 	beset 	beset#[bɪˈset]#bao quanh
bestrew 	bestrewed 	bestrewn / bestrewed#[bɪˈstruː]#rắc, rải
bet 	bet / betted 	bet / betted#[bet]#đánh cuộc
betake 	betook 	betaken#[bɪˈteɪk]#dấn thân vào, mắc vào, đam mê
bethink 	bethought 	bethought#[bɪˈθɪŋk]#nhớ ra, nghĩ ra
bid 	bid / bade 	bidden#[bɪd]#đặt giá
bind 	bound 	bound#[baɪnd]#buộc, trói
bite 	bit 	bitten#[baɪt]#cắn
bleed 	bled 	bled#[bliːd]#chảy máu, mất máu
blow 	blew 	blown#[bləʊ]#thổi
break 	broke 	broken#[breɪk]#đập vỡ
breed 	bred 	bred#[briːd]#nuôi, dạy dỗ
bring 	brought 	brought#[brɪŋ]#mang đến
broadcast 	broadcast / broadcasted 	broadcast / broadcasted#['brɔ:dkɑ:st; 'brɔ:dkæ:st]#phát thanh, phát sóng
browbeat 	browbeat 	browbeaten / browbeat#[ˈbraʊbiːt]#dọa nạt, bắt nạt
build 	built 	built#[bɪld]#xây dựng
burn 	burned / burnt 	burned / burnt#[bɜːn]#đốt, cháy
burst 	burst 	burst#[bɜːst]#nổ, vỡ
bust 	busted / bust 	busted / bust#[bʌst]#làm bể, làm vỡ
buy 	bought 	bought#[baɪ]#mua
cast 	cast 	cast#[kɑːst]#ném, tung
catch 	caught 	caught#[kætʃ]#bắt, chụp
chide 	chided / chid 	chided / chidden#[tʃaɪd]#mắng chửi
choose 	chose 	chosen#[tʃuːz]#chọn, lựa
clap 	clapped / clapt 	clapped / clapt#[klæp]#vỗ, vỗ tay
cling 	clung 	clung#[klɪŋ]#bám vào, níu lấy
clothe 	clothed / clad 	clothed / clad#[kləʊð]#mặc quần áo
come 	came 	come#[kʌm]#đến, đi đến
cost 	cost 	cost#[kɒst]#có giá là
creep 	crept 	crept#[kriːp]#bò, trườn, rón rén
cross breed 	cross bred 	cross bred#[ˈkrɒs briːd]#lai giống
cut 	cut 	cut#[kʌt]#cắt, chặt
dare 	dared / durst 	dared / durst#[deə(r)]#dám
daydream 	daydreamed / daydreamt 	daydreamed / daydreamt#[ˈdeɪdriːm]#nghĩ vẩn vơ
deal 	dealt 	dealt#[diːl]#giao thiệp
dig 	dug 	dug#[dɪɡ]#đào
dight 	dighted / dight 	dighted / dight#[]#trang điểm, chuẩn bị
disprove 	disproved 	disproved / disproven#[ˌdɪsˈpruːv]#bác bỏ, chứng minh là sai
dive 	dived / dove 	dived#[daɪv]#lặn, lao xuống
do 	did 	done#[]#làm, thực hiện
draw 	drew 	drawn#[drɔː]#vẽ
dream 	dreamed / dreamt 	dreamed / dreamt#[driːm]#mơ thấy
drink 	drank 	drunk#[drɪŋk]#uống
drive 	drove 	driven#[draɪv]#lái xe
dwell 	dwelt / dwelled 	dwelt / dwelled#[dwel]#trú ngụ, ở
eat 	ate 	eaten#[iːt]#ăn
enwind 	enwound 	enwound#[]#cuộn tròn, xung quanh
fall 	fell 	fallen#[fɔːl]#ngã, rơi
feed 	fed 	fed#[fiːd]#cho ăn, ăn, nuôi
feel 	felt 	felt#[fiːl]#cảm thấy
fight 	fought 	fought#[faɪt]#chiến đấu
find 	found 	found#[faɪnd]#tìm thấy, thấy
fit 	fitted / fit 	fitted / fit#[fɪt]#hợp, vừa
flee 	fled 	fled#[fliː]#chạy trốn, bỏ chạy, lẫn trốn
fling 	flung 	flung#[flɪŋ]#ném, vứt
fly 	flew 	flown#[flaɪ]#bay
forbear 	forbore 	forborne#[fɔːˈbeə(r)]#nhịn
forbid 	forbade 	forbidden#[fəˈbɪd]#cấm đoán, cấm
fordo 	fordid 	fordone#[]#tàn phá, phá hủy, giết
forecast 	forecast 	forecast#[ˈfɔːkɑːst]#tiên đoán
forego	forewent 	foregone#[fɔːˈɡəʊ]#đi trước, ở trước
foreknow 	foreknew 	foreknown#[]#biết trước
forerun 	foreran 	forerun#[]#báo hiệu, báo trước
foresee 	foresaw 	foreseen#[fɔːˈsiː]#nhìn thấy trước, đoán trước, biết trước
foreshow 	foreshowed 	foreshown / foreshowed#[]#nói trước, báo trước
foretell 	foretold 	foretold#[fɔːˈtel]#nói trước, đoán trước
forget 	forgot 	forgotten / forgot#[fəˈɡet]#quên
forgive 	forgave 	forgiven#[fəˈɡɪv]#tha thứ
forsake 	forsook 	forsaken#[fəˈseɪk]#ruồng bỏ
forswear 	forswore 	forsworn#[fɔːˈsweə(r)]#thề bỏ đi, thề chừa
freeze 	froze 	frozen#[friːz]#làm đông lại
frost bite 	frost bit 	frost bitten#[]#làm tê cóng, làm chết cóng
gainsay 	gainsaid 	gainsaid#[ˌɡeɪnˈseɪ]#chối cãi, không nhận
get 	got 	gotten / got#[ɡet]#có được
gild 	gilded / gilt 	gilded / gilt#[ɡɪld]#mạ vàng
give 	gave 	given#[ɡɪv]#cho
go 	went 	gone#[ɡəʊ]#đi
grind 	ground 	ground#[ɡraɪnd]#nghiền, xay
grow 	grew 	grown#[ɡrəʊ]#mọc, trồng
hamstring 	hamstrung 	hamstrung#[ˈhæmstrɪŋ]#làm què quặt
hand feed 	hand fed 	hand fed#[]#dùng tay cho ăn
hang 	hanged / hung 	hanged / hung#[hæŋ]#móc lên, treo lên
have 	had 	had#[həv]#có
hear 	heard 	heard#[hɪə(r)]#nghe
heave 	heaved / hove 	heaved / hove#[hiːv]#trục lên
hew 	hewed 	hewn / hewed#[hjuː]#chặt, đẽo, bổ
hide 	hid 	hidden#[haɪd]#giấu, trốn, ẩn, nấp
hit 	hit 	hit#[hɪt]#đụng
hold 	held 	held#[həʊld]#cầm, nắm, giữ vững
hurt 	hurt 	hurt#[hɜːt]#làm đau
inbreed 	inbred 	inbred#[]#bẩm sinh
inlay 	inlaid 	inlaid#[ˌɪnˈleɪ]#khảm, dát
input 	input / inputted 	input / inputted#[ˈɪnpʊt]#đưa vào (máy điện toán)
inset 	inset 	inset#[ˈɪnset]#cài, ghép
interbreed 	interbred 	interbred#[ˌɪntəˈbriːd]#giao phối, lai giống
intercut 	intercut 	intercut#[ˌɪntəˈkʌt]#xen cảnh
interlay 	interlaid 	interlaid#[]#đặt xen, dát xen
intersect 	intersected 	intersected#[ˌɪntəˈsekt]#cắt ngang nhau, chéo nhau
interweave 	interwove / interweaved 	interwoven / interweaved#[ˌɪntəˈwiːv]#trộn lẫn với nhau, xen lẫn
interwind 	interwound 	interwound#[]#cuộn vào với nhau, quấn vào với nhau
inweave 	inwove / inweaved 	inwoven / inweaved#[]#dệt lẫn, dệt xen
keep 	kept 	kept#[kiːp]#giữ
kneel 	knelt / kneeled 	knelt / kneeled#[niːl]#quỳ
knit 	knitted / knit 	knitted / knit#[nɪt]#đan
know 	knew 	known#[nəʊ]#biết, quen biết
lade 	laded 	laden / laded#[]#chất hàng
landslide 	landslid 	landslid#[ˈlændslaɪd]#lở (đất, đá...)
lay 	laid 	laid#[leɪ]#đặt, để
lead 	led 	led#[liːd]#dẫn dắt, lãnh đạo
lean 	leaned / leant 	leaned / leant#[liːn]#dựa, tựa, chống
leap 	leaped / leapt 	leaped / leapt#[liːp]#nhảy qua, vượt qua
learn 	learned / learnt 	learned / learnt#[lɜːn]#học, được biết
leave 	left 	left#[liːv]#ra đi, để lại
lend 	lent 	lent#[lend]#cho mượn (vay)
let 	let 	let#[let]#cho phép, để cho
lie 	lay 	lain#[laɪ]#nằm
lie 	lied 	lied#[laɪ]#nói dối
light 	lit / lighted 	lit / lighted#[laɪt]#thắp sáng
lip read 	lip read 	lip read#[ˈlɪp riːd]#hiểu bằng cách ra hiệu môi
lose 	lost 	lost#[luːz]#làm mất, mất
make 	made 	made#[meɪk]#chế tạo, sản xuất
mean 	meant 	meant#[miːn]#có nghĩa là
meet 	met 	met#[miːt]#gặp mặt
misbecome 	misbecame 	misbecome#[]#không thích hợp, không xứng
miscast 	miscast 	miscast#[ˌmɪsˈkɑːst]#chọn các vai đóng không hợp cho (một vở kịch)
misdeal 	misdealt 	misdealt#[]#chia bài sai, chia lộn bài
mishear 	misheard 	misheard#[ˌmɪsˈhɪə(r)]#nghe lầm
mishit 	mishit 	mishit#[ˈmɪshɪt]#ném (một quả bóng) một cách tồi
mislay 	mislaid 	mislaid#[ˌmɪsˈleɪ]#để lạc mất
mislead 	misled 	misled#[ˌmɪsˈliːd]#làm cho lạc đường
misread 	misread 	misread#[ˌmɪsˈriːd]#đọc sai
misspell 	misspelled / misspelt 	misspelled / misspelt#[ˌmɪsˈspel]#viết sai chính tả
mis spend 	mis spent 	mis spent#[]#tiêu phí, bỏ phí, uổng phí
mistake 	mistook 	mistaken#[mɪˈsteɪk]#phạm lỗi, nhầm lẫn
misunderstand 	misunderstood 	misunderstood#[ˌmɪsʌndəˈstænd]#hiểu lầm
mow 	mowed 	mowed / mown#[məʊ]#cắt, gặt (bằng liềm, hái)
offset 	offset 	offset#[ˈɒfset]#bù lại, đền bù, bù đắp
outbid 	outbid 	outbid#[ˌaʊtˈbɪd]#trả hơn giá
outdo 	outdid 	outdone#[ˌaʊtˈduː]#làm giỏi hơn
outdraw 	outdrew 	outdrawn#[]#có sức thu hút mạnh hơn
outfight 	outfought 	outfought#[ˌaʊtˈfaɪt]#đánh thắng
outfly 	outflew 	outflown#[]#bay qua
outgrow 	outgrew 	outgrown#[ˌaʊtˈɡrəʊ]#lớn hơn, mọc cao hơn
outlay 	outlaid 	outlaid#[ˈaʊtleɪ]#phủ lên
outlie	outlied 	outlied#[]#nằm ngoài trời
output 	output / outputted 	output / outputted#[ˈaʊtpʊt]#cung cấp
outride 	outrode 	outridden#[]#vượt qua được
outsell 	outsold 	outsold#[ˌaʊtˈsel]#bán chạy hơn, được giá hơn
outshine 	outshined / outshone 	outshined / outshone#[ˌaʊtˈʃaɪn]#sáng, chiếu sáng
outshoot 	outshot 	outshot#[]#bắn giỏi hơn, bắn vượt qua
outsing 	outsang 	outsung#[]#hát hay hơn, hát to hơn
outsit 	outsat 	outsat#[]#ngồi lâu hơn
outsleep 	outslept 	outslept#[]#ngủ lâu hơn, ngủ muộn hơn
outspeak 	outspoke 	outspoken#[]#nói nhiều hơn, nói to hơn
outspeed 	outsped 	outsped#[]#đi nhanh hơn, chạy nhanh hơn
outstand 	outstood 	outstood#[]#lộ hẳn ra, nổi bật
outswear 	outswore 	outsworn#[]#nguyền rủa nhiều hơn
outswim 	outswam 	outswum#[]#bơi giỏi hơn
outthink 	outthought 	outthought#[]#suy nghĩ nhanh hơn, suy nghĩ sâu sắc hơn
outthrow 	outthrew 	outthrown#[]#ném ra, đưa ra
outwear 	outwore 	outworn#[]#bền hơn, dùng được lâu hơn
outwind 	outwound 	outwound#[]#làm cho thở dốc ra
overbear 	overbore 	overborne / overborn#[]#đè xuống, nén xuống
overbid 	overbid 	overbid#[ˌəʊ.vəˈbɪd]#trả giá cao hơn, bỏ thầu cao hơn
overbuild 	overbuilt 	overbuilt#[]#xây trùm lên
overbuy 	overbought 	overbought#[ˌəʊvəˈbaɪ]#mua nhiều quá
overcast 	overcast 	overcast#[ˌəʊvəˈkɑːst]#che khuất, phủ mây (bầu trời)
overcome 	overcame 	overcome#[ˌəʊvəˈkʌm]#khắc phục
overdo 	 overdid 	overdone#[ˌəʊvəˈduː]#làm quá trớn, làm quá
overdraw 	overdrew 	overdrawn#[ˌəʊvəˈdrɔː]#phóng đại, cường điệu
overdrink 	overdrank 	overdrunk#[]#uống nhiều quá, uống quá mức
overeat 	overate 	overeaten#[ˌəʊvərˈiːt]#ăn quá nhiều, ăn quá mức
overfeed 	overfed 	overfed#[ˌəʊvəˈfiːd]#cho ăn quá mức
overhang 	overhung 	overhung#[ˌəʊvəˈhæŋ]#nhô ra ở trên, treo lơ lửng
overhear 	overheard 	overheard#[ˌəʊvəˈhɪə(r)]#nghe lỏm
overlay 	overlaid 	overlaid#[ˌəʊvəˈleɪ]#che, phủ lên
overleap 	overleaped / overleapt 	overleaped / overleapt#[]#nhảy qua, vượt qua
overlie 	overlay 	overlain#[ˌəʊvəˈlaɪ]#đặt lên trên, che, phủ
overpay 	overpaid 	overpaid#[ˌəʊvəˈpeɪ]#trả quá tiền
override 	overrode 	overridden#[ˌəʊvəˈraɪd]#cưỡi (ngựa) đến kiệt lực
overrun 	overran 	overrun#[ˈəʊvərʌn]#tràn qua, lan qua
oversee 	oversaw 	overseen#[ˌəʊvəˈsiː]#trông nom, giám thị
oversell 	oversold 	oversold#[ˌəʊvəˈsel]#bán chạy mạnh
overset 	overset 	overset#[]#làm đảo lộn, lật đổ
overshoot 	overshot 	overshot#[ˌəʊvəˈʃuːt]#đi quá đích
oversleep 	overslept 	overslept#[ˌəʊvəˈsliːp]#ngủ quên
overspend 	overspent 	overspent#[ˈəʊvəspend]#tiêu quá khả năng mình
overspread 	overspread 	overspread#[]#phủ khắp, phủ đầy, làm lan khắp
overstride 	overstrode 	overstridden#[]#vượt, hơn, trội hơn
overtake 	overtook 	overtaken#[ˌəʊvəˈteɪk]#bắt kịp, vượt
overthrow 	overthrew 	overthrown#[ˌəʊvəˈθrəʊ]#lật đổ, phá đổ, đạp đổ
overwear 	overwore 	overworn#[]#mặc đến hỏng, mặc đến rách ra
overwind 	overwound 	overwound#[]#quá cứng
overwrite 	overwrote 	overwritten#[ˌəʊvəˈraɪt]#viết đè lên, viết lên
partake 	partook 	partaken#[pɑːˈteɪk]#tham dự, cùng có phần, cùng hưởng
pay 	paid 	paid#[peɪ]#trả (tiền)
plead 	pleaded / pled 	pleaded / pled#[pliːd]#bào chữa, biện hộ
prepay 	prepaid 	prepaid#[ˌpriːˈpeɪ]#trả trước
preset 	preset 	preset#[ˌpriːˈset]#cài sẵn
proof read 	proof read 	proof read#[]#đọc thử
prove 	proved 	proven / proved#[pruːv]#chứng minh (tỏ)
put 	put 	put#[pʊt]#đặt, để
quit 	quit / quitted 	quit / quitted#[kwɪt]#rời đi, bỏ đi, nghỉ
read 	read (sounds like "red") 	read (sounds like "red")#[riːd]#đọc
rebind 	rebound 	rebound#[]#buộc lại
rebroadcast 	rebroadcast / rebroadcasted 	rebroadcast / rebroadcasted#[]#phát lại
rebuild 	rebuilt 	rebuilt#[ˌriːˈbɪld]#xây dựng lại
recast 	recast 	recast#[ˌriːˈkɑːst]#đúc lại, viết lại
recut 	recut 	recut#[]#cắt lại
redo 	redid 	redone#[ˌriːˈduː]#làm lại
redraw 	redrew 	redrawn#[ˌriːˈdrɔː]#vẽ lại
reeve 	reeved / rove 	reeved / rove#[riːv]#luồn, xỏ
refit 	refit / refitted 	refit / refitted#[ˌriːˈfɪt]#sửa chữa lại, trang bị lại
rehang 	rehung 	rehung#[]#treo lại
relay 	relayed /relaid 	relayed/relaid#[rɪˈleɪ]#tiếp sức
remake 	remade 	remade#[ˈriːmeɪk]#làm lại, chế tạo lại
rend 	rent / rended 	rent / rended#[rend]#toạc ra, xé
repay 	repaid 	repaid#[rɪˈpeɪ]#hoàn tiền lại
re read 	re read 	re read#[]#đọc lại
rerun 	reran 	rerun#[ˈriːrʌn]#chạy trở lại
resell 	resold 	resold#[ˌriːˈsel]#bán lại
reset 	reset 	reset#[ˌriːˈset]#cài đặt lại
rethink 	rethought 	rethought#[ˌriːˈθɪŋk]#suy nghĩ lại
retread 	retread 	retread#[ˈriːtred]#lại giẫm lên, lại đạp lên
retrofit 	retrofitted / retrofit 	retrofitted / retrofit#[ˈretrəʊfɪt]#trang bị thêm
rewind 	rewound 	rewound#[ˌriːˈwaɪnd]#tua lại(phim)
rewrite 	rewrote 	rewritten#[ˌriːˈraɪt]#viết lại
rid 	rid 	rid#[rɪd]#giải thoát
ride 	rode 	ridden#[raɪd]#cưỡi
ring 	rang 	rung#[rɪŋ]#rung chuông
rise 	rose 	risen#[raɪz]#đứng dậy, mọc
rive 	rived 	riven / rived#[raɪv]#chẻ ra, xé nát
run 	ran 	run#[rʌn]#chạy
sand cast 	sand cast 	sand cast#[ˈsænd.kɑːst]#đổ vào khuôn cát
saw 	sawed 	sawed / sawn#[sɔː]#cưa
say 	said 	said#[seɪ]#nói
see 	saw 	seen#[siː]#nhìn thấy
seek 	sought 	sought#[siːk]#tìm kiếm
self feed 	self fed 	self fed#[]#tự nuôi dưỡng
sell 	sold 	sold#[sel]#bán
send 	sent 	sent#[send]#gửi
set 	set 	set#[set]#để, đặt
sew 	sewed 	sewn / sewed#[səʊ]#may
shake 	shook 	shaken#[ʃeɪk]#rung, lay, lắc
shave 	shaved 	shaved / shaven#[ʃeɪv]#cạo (râu, mặt)
shear 	sheared 	sheared / shorn#[ʃɪə(r)]#xén lông (cừu)
shed 	shed 	shed#[ʃed]#rơi, rụng
shine 	shined / shone 	shined / shone#[ʃaɪn]#chiếu sáng
shit 	shit / shat / shitted 	shit / shat / shitted#[ʃɪt]#đi ỉa
shoe 	shoed / shod 	shoed / shod#[ʃuː]#đi giày (cho ai)
shoot 	shot 	shot#[ʃuːt]#bắn
show 	showed 	shown / showed#[ʃəʊ]#cho xem
shrink 	shrank / shrunk 	shrunk#[ʃrɪŋk]#co rút
shrive 	shrived / shrove 	shriven#[ʃraɪv]#nghe xưng tội
shut 	shut 	shut#[ʃʌt]#đóng lại
sing 	sang 	sung#[sɪŋ]#ca hát
sink 	sank / sunk 	sunk#[sɪŋk]#chìm, lặn
sit 	sat 	sat#[sɪt]#ngồi
slay 	slew / slayed 	slain / slayed#[sleɪ]#sát hại, giết hại
sleep 	slept 	slept#[sliːp]#ngủ
slide 	slid 	slid#[slaɪd]#trượt, lướt
sling 	slung 	slung#[slɪŋ]#ném mạnh
slink 	slinked / slunk 	slinked / slunk#[slɪŋk]#lẻn đi
slit 	slit 	slit#[slɪt]#chẻ, cắt, rọc, xé toạc
smell 	smelled / smelt 	smelled / smelt#[smel]#ngửi
smite 	smote 	smitten / smote#[smaɪt]#đập mạnh
sneak 	sneaked / snuck 	sneaked / snuck#[sniːk]#trốn, lén
sow 	sowed 	sown / sowed#[səʊ]#gieo, rải
speak 	spoke 	spoken#[spiːk]#nói
speed 	sped / speeded 	sped / speeded#[spiːd]#chạy vụt
spell 	spelled / spelt 	spelled / spelt#[spel]#đánh vần
spend 	spent 	spent#[spend]#tiêu xài, sử dụng
spill 	spilled / spilt 	spilled / spilt#[spɪl]#tràn đổ ra
spin 	spun 	spun#[spɪn]#quay sợi
spit 	spit / spat 	spit / spat#[spɪt]#khạc nhổ
split 	split 	split#[splɪt]#ghẻ, bửa, tách
spoil 	spoiled / spoilt 	spoiled / spoilt#[spɔɪl]#làm hỏng
spread 	spread 	spread#[spred]#lan truyền
spring 	sprang / sprung 	sprung#[sprɪŋ]#nhảy
stall feed 	stall fed 	stall fed#[]#vỗ béo bằng cỏ khô, nuôi bằng cỏ khô
stand 	stood 	stood#[stænd]#đứng
stave 	staved / stove 	staved / stove#[steɪv]#đâm thủng
steal 	stole 	stolen#[stiːl]#đánh cắp
stick 	stuck 	stuck#[stɪk]#ghim vào, đính
sting 	stung 	stung#[stɪŋ]#châm, chích, đốt
stink 	stunk / stank 	stunk#[stɪŋk]#bốc mùi hôi
strew 	strewed 	strewn / strewed#[struː]#rắc, rải
stride 	strode 	stridden#[straɪd]#bước sải
strike 	struck 	struck / stricken#[straɪk]#đánh đập
string 	strung 	strung#[strɪŋ]#gắn dây vào
strip 	stripped / stript 	stripped / stript#[strɪp]#cởi quần áo, phóng ra (đạn)
strive 	strove / strived 	striven / strived#[straɪv]#cố sức
sublet 	sublet 	sublet#[ˌsʌbˈlet]#cho thuê lại
sunburn 	sunburned / sunburnt 	sunburned / sunburnt#[ˈsʌnbɜːn]#bị cháy nắng
swear 	swore 	sworn#[sweə(r)]#tuyên thệ
sweat 	sweat / sweated 	sweat / sweated#[swet]#đổ mồ hôi, toát mồ hôi
sweep 	swept 	swept#[swiːp]#quét
swell 	swelled 	swollen / swelled#[swel]#phồng, sưng
swim 	swam 	swum#[swɪm]#bơi, lội
swing 	swung 	swung#[swɪŋ]#đong đưa, lắc
take 	took 	taken#[teɪk]#cầm, lấy
teach 	taught 	taught#[tiːtʃ]#dạy, giảng dạy
tear 	tore 	torn#[teər]#xé, rách
telecast 	telecast 	telecast#[ˈtelikɑːst]#phát đi bằng truyền hình
tell 	told 	told#[tel]#kể, bảo
think 	thought 	thought#[θɪŋk]#suy nghĩ
thrive 	thrived / throve 	thrived / thriven#[θraɪv]#thịnh vượng, phát đạt
throw 	threw 	thrown#[θrəʊ]#ném, liệng
thrust 	thrust 	thrust#[θrʌst]#thọc, nhấn
tread 	trod 	trodden / trod#[tred]#giẫm, đạp
troubleshoot 	troubleshot 	troubleshot#[ˈtrʌblʃuːt]#khắc phục sự cố
type cast 	type cast 	type cast#[]#định kiểu
typeset 	typeset 	typeset#[ˈtaɪpset]#sắp chữ
typewrite 	typewrote 	typewritten#[]#đánh máy
unbear 	unbore 	unborn / unborne#[]#nới, cởi dây cương (ngựa)
unbend 	unbent 	unbent#[ˌʌnˈbend]#làm thẳng lại
unbind 	unbound 	unbound#[ʌnˈbaɪnd]#mở, cởi, tháo
unbuild 	unbuilt 	unbuilt#[]#phá sạch, san phẳng
unclothe 	unclothed / unclad 	unclothed / unclad#[]#cởi áo, lột trần
underbid 	underbid 	underbid#[ˌʌndəˈbɪd]#bỏ thầu rẻ hơn
underbuy 	underbought 	underbought#[]#mua giá hạ, mua giá rẻ
undercut 	undercut 	undercut#[ˌʌndəˈkʌt]#ra giá rẻ hơn
underfeed 	underfed 	underfed#[]#cho thiếu ăn, cho ăn đói
undergo 	underwent 	undergone#[ˌʌndəˈɡəʊ]#kinh qua
underlay 	underlaid 	underlaid#[ˈʌndəleɪ]#đặt bên dưới, đỡ, trụ
underlie 	underlay 	underlain#[ˌʌndəˈlaɪ]#nằm dưới
underrun 	underran 	underrun#[]#chạy qua phía dưới
undersell 	undersold 	undersold#[ˌʌndəˈsel]#bán rẻ hơn
undershoot 	undershot 	undershot#[ˌʌndəˈʃuːt]#không tới địch (bắn súng)
underspend 	underspent 	underspent#[ˌʌndəˈspend]#chi tiêu ít hơn
understand 	understood 	understood#[ˌʌndəˈstænd]#hiểu
undertake 	undertook 	undertaken#[ˌʌndəˈteɪk]#đảm nhận
underwrite 	underwrote 	underwritten#[ˌʌndəˈraɪt]#bảo hiểm
undo 	undid 	undone#[ʌnˈduː]#tháo ra
undraw 	undrew 	undrawn#[]#kéo ra, mở ra
unfreeze 	unfroze 	unfrozen#[ˌʌnˈfriːz]#làm cho tan ra
unhang 	unhung 	unhung#[]#hạ xuống, bỏ xuống
unknit 	unknitted / unknit 	unknitted / unknit#[]#dãn ra, tháo ra
unlade 	unladed 	unladen / unladed#[]#dỡ hàng, giái phóng
unlay 	unlaid 	unlaid#[]#tháo (dây thừng) ra từng sợi
unlead 	unleaded 	unleaded#[]#bỏ thanh cỡ
unlearn 	unlearned / unlearnt 	unlearned / unlearnt#[ˌʌnˈlɜːn]#quên (những điều đã học)
unmake 	unmade 	unmade#[ʌnˈmeɪk]#phá đi
unreeve 	unreeved / unrove 	unreeved / unrove#[]#tháo rút (dây)
unsay 	unsaid 	unsaid#[]#chối, nuốt lời
unsew 	unsewed 	unsewn / unsewed#[]#tháo đường may
unstick 	unstuck 	unstuck#[]#bóc, gỡ
unstring 	unstrung 	unstrung#[]#tháo dây, cởi dây
unswear 	unswore 	unsworn#[]#thề ngược lại, hủy bỏ lời thề
unteach 	untaught 	untaught#[]#dạy điều ngược lại, quên điều đã được dạy
unweave 	unwove / unweaved 	unwoven / unweaved#[]#tháo ra
unwind 	unwound 	unwound#[ˌʌnˈwaɪnd]#tháo ra, trải ra
uphold 	upheld 	upheld#[ʌpˈhəʊld]#ủng hộ
upset 	upset 	upset#[ˌʌpˈset]#đánh đổ, lật đổ
vex 	vexed / vext 	vexed / vext#[veks]#làm bực mình, làm phật ý
wake 	woke / waked 	woken / waked#[weɪk]#thức giấc
waylay 	waylaid 	waylaid#[weɪˈleɪ]#mai phục
wear 	wore 	worn#[weə(r)]#mặc
weave 	wove / weaved 	woven / weaved#[wiːv]#dệt
wed 	wed / wedded 	wed / wedded#[wed]#kết hôn
weep 	wept 	wept#[wiːp]#khóc
wet 	wet / wetted 	wet / wetted#[wet]#làm ướt
whet 	whetted 	whetted#[wet]#mài (cho sắc)
win 	won 	won#[wɪn]#thắng, chiến thắng
wind 	wound 	wound#[wɪnd]#quấn
withdraw 	withdrew 	withdrawn#[wɪðˈdrɔː]#rút lui
withhold 	withheld 	withheld#[wɪðˈhəʊld]#từ khước
withstand 	withstood 	withstood#[wɪðˈstænd]#cầm cự
wring 	wrung 	wrung#[rɪŋ]#vặn, siết chặt
write 	wrote 	written#[raɪt]#viết